0000000000000000000000000000000000000000
0333333333333333330333333333333333333330
0333333345333333330333333333333333333330
0333333367333333330333333333333333333330
0333333333333333333333333333333333333330
0333333333333333333333333333303333333330
0000003333300000000333333333003333333330
0333333333333333330333333330003333333330
0333333333333333330333333333333333333330
0333333333333333330333333333333333333330
0333333333333333330333333333333333333330
0333333333333333330333333333300333333330
0333333333333333330333333333300333333330
0333333333333333330333333333333333333330
0333333333333333330333333333333333333330
0333333333333333330333333333333333333330
0333333333333333333333333333333333333330
0333333333333333333333333333333333333330
0333333333333333333333333333333333333330
0333333333333333333333333333333333333330
0333333333333333333333333333333333333330
0333333333333333333333333333333333333330
0333333333333333333333333333333333333330
0333333333333333333333333333333333333330
0333333333333333333333333333333333333330
0333333333333333333333333333333333333330
0333333333333333333333333333333333333330
0333333333333333333333333333333333333330
0333333333333333333333333333333333333330
0333333333333333333333333333333333333330
0333333333333333333333333333333333333330
0333333333333333333333333333333333333330
0333333333333333333333333333333333333330
0333333333333333333333333333333333333330
0333333333333333333333333333333333333330
0333333333333333333333333333333333333330
0333333333333333333333333333333333333330
0333333333333333333333333333333333333330
0333333333333333333333333333333333333330
0000000000000000000000000000000000000000